
dat1 = "kakazezekakazeka00zezezezezekakazezeka00zeze00zekaze00ka00000000kazeze0000000000le000000000000000000le0000st000000000000lele000000000000le0000000000000000le000000000000le00000000";
dat2 = "00200020010001000020002001000020000001000100010001000100002000200100010000200000010001000000010000200100000000200000000000000000002001000100000000000000000000000100000000000000000000000000000000000000010000000000001000000000000000000000000001000100000000000000000000000000010000000000000000000000000000000000010000000000000000000000000001000000000000000000";
dat3 = "00000000000000000000000000000000000000000000000000000000000000000000000000000000000000000000000000000000000000000000000000000000000000000000000000000000000000000000000000000000000000000000000000000000000000000000000000000000000000000000000000000000000000000000000000000000000000000000000000000000000000000000000000000000000000000000000000000000000000000000";
dat4 = "00010001000100010001000100010001000100010001000100010001000100010001000100010001000100010001000100010001000100010001000100010001000100010001000100010001000100010001000100010001000100010001000100010001000100010001000100010001000100010001000100010001000100010001000100010001000100010001000100010001000100010001000100010001000100010001000100010001000100010001";
dat5 = "1212121212121212191212121212121212121219121219121212191219191919121212191919191915191919191919191919151919191919191919191515191919191919151919191919191916151919191919161516191919";
dat6 = "0205040403040505020201030205040202010503050503040103050502030503050303050302010104030505050403010304010303050505030404040203030205030505040501030204010403010505030502040303010502";
dat7 = "00010001000100010001000100010001000100010001000100010001000100010001000100010001000100010001000100010001000100010001000100010001000100010001000100010001000100010001000100010001000100010001000100010001000100010001000100010001000100010001000100010001000100010001000100010001000100010001000100010001000100010001000100010001000100010001000100010001000100010001";
dat8 = "05240523051005180510050705050510050005000529050505270508050005150501051105100500051405100500052805070509050005110500050005000500052005040512050005000500050005000500050005000500050005000500050005000500050005000500050005000500050005000500050005000500050005000500050005000500050005000500050005000500050005000500050005000500050005000500050005000500050005000500";