
dat1 = "00vehlzu0000le00000000dodotr0000lele0000dokyamscsktd00000000padodoba000000000000pa00vddo000000000000pa0000do000000000000papa0000000000000000000000000000000000000000000000000000000000000000000000000000";
dat2 = "0000012010000120000000000100000000000000000000500050007000000000010001000000000000500120010001200100002000000000000000000010005000500070000000000000000000000000001000000050005000000000000000000000000000100000000000500000000000000000000000000010001000000000000000000000000000000000000000000000000000000000000000000000000000000000000000000000000000000000000000000000000000000000000000000000000000000000";
dat3 = "0000002700260027000000000000000000000000000000290032002900000000000000000000000000180022003300210017001600000000000000000018002100240021000000000000000000000000001600000018000000000000000000000000000000000000000000000000000000000000000000000000000000000000000000000000000000000000000000000000000000000000000000000000000000000000000000000000000000000000000000000000000000000000000000000000000000000000";
dat4 = "0001000200020002000100010001000100010001000100020002000200010001000100010001000100020002000200020002000200010001000100010002000200020002000100010001000100010001000200010002000200010001000100010001000100020001000100020001000100010001000100010002000200010001000100010001000100010001000100010001000100010001000100010001000100010001000100010001000100010001000100010001000100010001000100010001000100010001";
dat5 = "10191919191915191019101919191019151519191919191919191910101919191919191019191019191919191919191919191919191919191019191919191919191910191919191919191919191916161919191919191919161619191919191910191616";
dat6 = "04020101010402010104050404040201050205010103020301020205040412050302010501040404100403050404050103031001050301040502050106150405020102050101040304010205040404040204030205040204020101010205020403050505";
dat7 = "0001000100110001000100010001000100010001000100010001000600010001000100010001000100010002000100010001000100010001000100010001000100130001000100010001000100010001000100010001000100010001000100010001000100010001000100010001000100010001000100010001000100010001000100010001000100010001000100010001000100010001000100010001000100010001000100010001000100010001000100010001000100010001000100010001000100010001";
dat8 = "0500050005000500050005000500050005000500050005000500050005000500050005000500050005000500050005000500050005000500050005000500050005000500050005000500050005000500050005000500050005000500050005000500050005000500050005000500050005000500050005000500050005000500050005000500050005000500050005000500050005000500050005000500050005000500050005000500050005000500050005000500050005000500050005000500050005000500";