
dat1 = "00le00le000000000000000000lele0000le0000000000lele0000lele000000000000lelele0000000000lele000000le0000000000le000000lele0000000000le0000lele0000le0000le00lelelelelelelelelelele00lelelelele00lelelele00";
dat2 = "0000010000000100000000000000000000000000000000000000010001000000000001000000000000000000000001000100000000000100010000000000000000000000000001000100010000000000000000000000010001000000000000000100000000000000000000000100000000000000010001000000000000000000000001000000000001000100000000000100000000000100000001000100010001000100010001000100010001000100000001000100010001000100000001000100010001000000";
dat3 = "0000000000000000000000000000000000000000000000000000000000000000000000000000000000000000000000000000000000000000000000000000000000000000000000000000000000000000000000000000000000000000000000000000000000000000000000000000000000000000000000000000000000000000000000000000000000000000000000000000000000000000000000000000000000000000000000000000000000000000000000000000000000000000000000000000000000000000";
dat4 = "0001000100010001000100010001000100010001000100010001000100010001000100010001000100010001000100010001000100010001000100010001000100010001000100010001000100010001000100010001000100010001000100010001000100010001000100010001000100010001000100010001000100010001000100010001000100010001000100010001000100010001000100010001000100010001000100010001000100010001000100010001000100010001000100010001000100010001";
dat5 = "19151915161916161919191919151516161519191919191515161615151919191919191515151919191919151519191915191919191915191919151519191919191519191515191915191915191515151515151515151515191515151515191515151519";
dat6 = "05020402020404040503040503030304010102040103050102040204020101030203030202020303040105020303050405010404050502020301040102040402030201020204030105010101030405050404040403010503020404010404020105050104";
dat7 = "0001000100010001000100010001000100010001000100010001000100010001000100010001000100010001000100010001000100010001000100010001000100010001000100010001000100010001000100010001000100010001000100010001000100010001000100010001000100010001000100010001000100010001000100010001000100010001000100010001000100010001000100010001000100010001000100010001000100010001000100010001000100010001000100010001000100010001";
dat8 = "0500050005000500050005000500050005000500050005000500050005000500050005000500050005000500050005000500050005000500050005000500050005000500050005000500050005000500050005000500050005000500050005000500050005000500050005000500050005000500050005000500050005000500050005000500050005000500050005000500050005000500050005000500050005000500050005000500050005000500050005000500050005000500050005000500050005000500";