
dat1 = "0000000000000000000000000000000000000000pm0000000000zg00000000000000000000lele000000000000lele0000lelele00lele000000lele0000";
dat2 = "00000000000000000000000000000000000000000000000000000000000000000000000000000000001000000000000000000000010000000000000000000000000000000000000000000100010000000000000000000000000001000100000000000100010001000000010001000000000000000100010000000000";
dat3 = "00000000000000000000000000000000000000000000000000000000000000000000000000000000000000000000000000000000000100000000000000000000000000000000000000000000000000000000000000000000000000000000000000000000000000000000000000000000000000000000000000000000";
dat4 = "00010001000100010001000100010001000100010001000100010001000100010001000100010001000100010001000100010001000100010001000100010001000100010001000100010001000100010001000100010001000100010001000100010001000100010001000100010001000100010001000100010001";
dat5 = "1616161619191616161919191619161619191916161916161919191919191619191919161915151916161919191515191615151519151516161615151019";
dat6 = "0501010502020502020503020404010103020503030203020404020305050304010404030201020105040303040404020501020201010301040203010305";
dat7 = "00010001000100010001000100010001000100010001000100010001000100010001000100010001000100010001000100010001000100010001000100010001000100010001000100010001000100010001000100010001000100010001000100010001000100010001000100010001000100010001000100010001";
dat8 = "05000500050005000500050005000500050005000500050005000500050005000500050005000500050005000500050005000500050005000500050005000500050005000500050005000500050005000500050005000500050005000500050005000500050005000500050005000500050005000500050005000500";