
dat1 = "0000lezekakazekalele0000le00lelelelelele00le00lele00lelele00le00le00lelelelele000000lelelelelelele0000lelelelelelelelelele00lelelele00le00lelele00hrhrhrle00le00lehrhrhr000000lelelelelevv0000le00000000";
dat2 = "0000000001000100002000200100002001000100000000000100000001000100010001000100010000000100000001000100000001000100010000000100000001000000010001000100010001000000000000000100010001000100010001000100000000000100010001000100010001000100010001000100000001000100010001000000010000000100010001000000020002000200010000000100000001000200020002000000000000000100010001000100010003000000000001000000000000000000";
dat3 = "0000000000000000000000000000000000000000000000000000000000000000000000000000000000000000000000000000000000000000000000000000000000000000000000000000000000000000000000000000000000000000000000000000000000000000000000000000000000000000000000000000000000100001000100010000000000000000001000110012001300130002000100000000000000110012001300130012000100000000000000000010001100110011001000100000000000000000";
dat4 = "0001000100010001000100010001000100010001000100010001000100010001000100010001000100010001000100010001000100010001000100010001000100010001000100010001000100010001000100010001000100010001000100010001000100010001000100010001000100010001000100010001000100010001000100010001000100010001000100010001000100010001000100010001000100010001000100010001000100010001000100010001000100010001000100010001000100010001";
dat5 = "19191512121212121515191915191515151515151915191515191515151415191519151515151514191915151515151515141915151515151515151515191515151514151915151510191414151415191519191914141415151515151919141519141414";
dat6 = "01040505030204020204040402040402040503030501030204040302010104030304010404010301040402020405050101020201010501040204040402020401040301030104010505040715020301030108031301050505020405041404040201010101";
dat7 = "0001000100010001000100010001000100010001000100010001000100010001000100010001000100010001000100010001000100010001000100010001000100010001000100010001000100010001000100010001000100010001000100010001000100010001000100010001000100010001000100010001000100010001000100010001000100010001000100010001000100010001000100010001000100010001000100010001000100010001000100010001000100010001000100010001000100010001";
dat8 = "0500050005000501051805230520052605000500050005000500050005000500050005000500050005000500050005000500050005000500050005000500050005000500050005000500050005000500050005000500050005000500050005000500050005000500050005000500050005000500050005000500050005000500050005000500050005000500050005000500050005000500050005000500050005000500050005000500050005000500050005000500050005000500050005000500050005000500";