
dat1 = "0000000000000000000000000000zpzpzpzp000000000000000000zpzp00000000000000000000000000000000000000000000000000000000000000000000000000000000000000000000zp00000000000000000000000000000000000000dozp000000";
dat2 = "0000000000000000000000000000000000000000000000000000000001000100010001000000000000000000000000000000000000500100010000000000000000000000000000000000000000000000000000000000000000000000000000000000000000000000000000000000000000000000005000000000000000000000000000000000000000000000000000000000000000000100000000000000000000000000000000000000000000000000000000000000000000000000000000500100000000000000";
dat3 = "0014002100210022003100280021003600290030001400210021002100210021001400210021002100140021002100210021002100070007001400140007001400210014001400070007000700070007000000070007000700070007000700070007000700000000000700070007000700070007000700070000000000000007000700070007000700070007000000000000000700070007000700070007000700000000000000000007000800070007000700070000000000010000000100080008000700070007";
dat4 = "0001000100010001000100010001000100010001000100010001000100010001000100010001000100010001000100010001000100010001000100010001000100010001000100010001000100010001000100010001000100010001000100010001000100010001000100010001000100010001000100010001000100010001000100010001000100010001000100010001000100010001000100010001000100010001000100010001000100010001000100010001000100010001000100010001000100010001";
dat5 = "19191919191919191919101910191919191919191910191919191919191919191010101919191919191010101010101919191010101010101919191910101010191919191919101010101019191919191010101019191919191919101010191919191019";
dat6 = "02010505020302020501010104030807071104030501010303040306150505050405040404050103050203010105030303020203040503010102030404020503040303040102030201020516050405050402030204040101030503040303020316020103";
dat7 = "0001000100010001000100010001000100010001000100010001000100010001000100010001000100010001000100010001000100010001000100010001000100010001000100010001000100010001000100010001000100010001000100010001000100010001000100010001000100010001000100010001000100010001000100010001000100010001000100010001000100010001000100010001000100010001000100010001000100010001000100010001000100010001000100010001000100010001";
dat8 = "0500050005000500050005000500050005000500050005000500050005000500050005000500050005000500050005000500050005000500050005000500050005000500050005000500050005000500050005000500050005000500050005000500050005000500050005000500050005000500050005000500050005000500050005000500050005000500050005000500050005000500050005000500050005000500050005000500050005000500050005000500050005000500050005000500050005000500";