
dat1 = "00000000le000000000000000000lelelele0000000000le00lelele000000lele0000lelele0000lelelelele00lele0000lelelelelele00zplelelelelelelelele00000000lele00lelelelele000000000000lelele00000000lelele";
dat2 = "00000000000000000100000000000000000000000000000000000000010001000100010000000000000000000000010000000100010001000000000000000100010000000000010001000100000000000100010001000100010000000100010000000000010001000100010001000100000001000100010001000100010001000100010001000000000000000000010001000000010001000100010001000000000000000000000000000100010001000000000000000000010001000100";
dat3 = "00000000000000000000000000000000000000000000000000000000000000000000000000000000000000000000000000000000000000000000000000000000000000000000000000000000000000000000000000000000000000000000000000000000000000000000000000000000000000000000000000000000000000000000000000000000000000000000000000000000000000000000000000000000000000000000000000000000000000000000000000000000000000000010";
dat4 = "00010001000100010001000100010001000100010001000100010001000100010001000100010001000100010001000100010001000100010001000100010001000100010001000100010001000100010001000100010001000100010001000100010001000100010001000100010001000100010001000100010001000100010001000100010001000100010001000100010001000100010001000100010001000100010001000100010001000100010001000100010001000100010001";
dat5 = "1919101915191919191919191919151515151919191910151915151519191915151919151515191915151515151915151919151515151515191915151515151515151519191919151519151515151519191919191915151519191919151515";
dat6 = "0203020204010305020303050403050104040404020301050102010502040503010504010503030205010501040401020403030404050504051601010501050104020201020405030301020402040204030201020402010203030201050104";
dat7 = "00010001000100010001000100010001000100010001000100010001000100010001000100010001000100010001000100010001000100010001000100010001000100010001000100010001000100010001000100010001000100010001000100010001000100010001000100010001000100010001000100010001000100010001000100010001000100010001000100010001000100010001000100010001000100010001000100010001000100010001000100010001000100010001";
dat8 = "05000500050005000500050005000500050005000500050005000500050005000500050005000500050005000500050005000500050005000500050005000500050005000500050005000500050005000500050005000500050005000500050005000500050005000500050005000500050005000500050005000500050005000500050005000500050005000500050005000500050005000500050005000500050005000500050005000500050005000500050005000500050005000500";