
dat1 = "lelelelelelelelelezelele00lelelelelezezelelelelelelelelelelelelelelelelelelelele00lelelelelelelelelelelelelelelelelelele00lelelelele00lelelelelelele000000000000lelele0000000000000000lelele000000000000";
dat2 = "0100010001000100010001000100010001000100010001000000010001000100010001000100010001000100010001000100010001000100010001000100010001000100010001000100010001000100000001000100010001000100010001000100010001000100010001000100010001000100010001000000010001000100010001000000010001000100010001000100010000000000000000000000000001000100010000000000000000000000000000000000010001000100000000000000000000000000";
dat3 = "0007000700070007000700000000000000000000000700070007000000000000000000000000000000070000000000000000000000000000000000000000000000000000000000000000000000000000000000000000000000000000000000000000000000000000000000000000000000000000000000000000000000000000000000000000000000000000000000000000000000000000000000000000000000000000000000000000000000000000000000000000000000000000000000000000000000000000";
dat4 = "0001000100010001000100010001000100010001000100010001000100010001000100010001000100010001000100010001000100010001000100010001000100010001000100010001000100010001000100010001000100010001000100010001000100010001000100010001000100010001000100010001000100010001000100010001000100010001000100010001000100010001000100010001000100010001000100010001000100010001000100010001000100010001000100010001000100010001";
dat5 = "15151515151515151512151519151515151512121515151515151515151515151515151515151515191515151515151515151515151515151515151519151515151516151515151515151616161616161515151616161616161619151515161616161616";
dat6 = "03010505040101050201040203030101040304010304040404040201010503040301020203030204050501050404020304040203020403050305020104030203010205020502040202050203040403040302020304020301050303030102040203040205";
dat7 = "0001000100010001000100010001000100010001000100010001000100010001000100010001000100010001000100010001000100010001000100010001000100010001000100010001000100010001000100010001000100010001000100010001000100010001000100010001000100010001000100010001000100010001000100010001000100010001000100010001000100010001000100010001000100010001000100010001000100010001000100010001000100010001000100010001000100010001";
dat8 = "0500050005000500050005000500050005000527050005000500050005000500050005000505051805000500050005000500050005000500050005000500050005000500050005000500050005000500050005000500050005000500050005000500050005000500050005000500050005000500050005000500050005000500050005000500050005000500050005000500050005000500050005000500050005000500050005000500050005000500050005000500050005000500050005000500050005000500";