
dat1 = "00lelelele00000000000000le00lelele0000000000lele0000000000le00000000za0000000000000000000000000000000000000000000000le000000000000000000leleja000000000000lelele0000000000000000lele00000000000000000000";
dat2 = "0000010001000100010000000000000000000000000000000100000001000100010000000000000000000000010001000000000000000000000001000000000000000000010000000000000000000000000000000000000000000000000000000000000000000000000000000000000000000000010000000000000000000000000000000000000001000100001000000000000000000000000001000100010000000000000000000000000000000000010001000000000000000000000000000000000000000000";
dat3 = "0000000000000000000000000000000000000000000000000000000000000000000000000000000000000000000000000000000000000000000000000000000000000000000000000000000000000000000000000000000000000000000000000000000000000000000000000000000000000000000000000000000000000000000000000000000000000000000000000000000000000000000000000000000000000000000000000000000000000000000000000000000000000000000000000000000000000000";
dat4 = "0001000100010001000100010001000100010001000100010001000100010001000100010001000100010001000100010001000100010001000100010001000100010001000100010001000100010001000100010001000100010001000100010001000100010001000100010001000100010001000100010001000100010001000100010001000100010001000100010001000100010001000100010001000100010001000100010001000100010001000100010001000100010001000100010001000100010001";
dat5 = "19151515151616161616191915191515151616161919151519161616161519191916161616161916191919191616161619191919191919161616151919191919161616161515191919191616161515151919191916161616151519191919191616161619";
dat6 = "01040501040305050301020301020201050105020103030405040503010305010405020201050203030202040101010402050305020403040304010205010203020405040301040103050502020403040503020201030303020103030105050301030505";
dat7 = "0001000100010001000100010001000100010001000100010001000100010001000100010001000100010001000100010001000100010001000100010001000100010001000100010001000100010001000100010001000100010001000100010001000100010001000100010001000100010001000100010001000100010001000100010001000100010001000100010001000100010001000100010001000100010001000100010001000100010001000100010001000100010001000100010001000100010001";
dat8 = "0500050005000500050005000500050005000500050005000500050005000500050005000500050005000500050005000500050005000500050005000500050005000500050005000500050005000500050005000500050005000500050005000500050005000500050005000500050005000500050005000500050005000500050005000500050005000500050005000500050005000500050005000500050005000500050005000500050005000500050005000500050005000500050005000500050005000500";