
dat1 = "akakakakst00000000zp000000000000000000000000000000000000000000pm00000000000000000000000000000000000000000000000000000000000000000000000000000000lele0000000000000000lelezp00000000za000000lele00";
dat2 = "999999999999999900100000000000000000010000000000000000000000000000000000000000000000000000000000000000000000000000000000000000100000000000000000000000000000000000000000000000000000000000000000000000000000000000000000000000000000000000000000000000000000000000000190000000000000000000000000010001000070002000000000000000000000000001000100010001000000000000000100000000000000010001000020";
dat3 = "000000000000000000000000000000000000000000000000000000000000000000000000000000000000000000000000000000000000000000000000000000000000000000000000000000000000000000000000000000000000000000000000000000000000000000000000000000000000000000000000000000000000000000000000000000000000000000000000000000000000000000000000000000000000000000000000000000000000000000000000000000000000000000000000";
dat4 = "000100010001000100010001000100010001000100010001000100010001000100010001000100010001000100010001000100010001000100010001000100010001000100010001000100010001000100010001000100010001000100010001000100010001000100010001000100010001000100010001000100010001000100010001000100010001000100010001000100010001000100010001000100010001000100010001000100010001000100010001000100010001000100010001";
dat5 = "101919191919191919191019191919191919101919191919191919191919101919191919191919191919191919191919191919191919101919191919191919191919191919191919151519191919191919191515191919191919191919151519";
dat6 = "070707150402040204160301050405020201030503010501050103020102050405030204010104050402040105050102050102040102010502030505020504040102050505020104020105010502020303050205160501050502030504010205";
dat7 = "000100010001000100010001000100010001000100010001000100010001000100010001000100010001000100010001000100010001000100010001000100010001000100010001000100010001000100010001000100010001000100010001000100010001000100010001000100010001000100010001000100010001000100010001000100010001000100010001000100010001000100010001000100010001000100010001000100010001000100010001000100010001000100010001";
dat8 = "050005000500050005000500050005000500050005000500050005000500050005000500050005000500050005000500050005000500050005000500050005000500050005000500050005000500050005000500050005000500050005000500050005000500050005000500050005000500050005000500050005000500050005000500050005000500050005000500050005000500050005000500050005000500050005000500050005000500050005000500050005000500050005000500";