
dat1 = "le00000000000000000000le00lele000000000000lelele000000000000lelelele000000zp0000lelele00le00le00le0000le000000le00le0000000000000000lele00000000000000le00le0000000000lelele00lele0000lelelelelelelezeze";
dat2 = "0100000000000000000000000000000000000000000001000000010001000000000000000000000000000100010001000000000000000000000000000100010001000100000000000000010000000000010001000100000001000000010000000100000000000100000000000000010000000100000000000000000000000000000000000100010000000000000000000000000000000100000001000000000000000000000001000100010000000100010000000000010001000100010001000100010001000100";
dat3 = "0007000700070007000700070007000700070007000700070007000700070007000700070007000700070007000700070007000700070007000700070007000700070007000700070007000700070007000700070007000700070007000700070007000000070007000700070007000700070007000700000007000700070007000700070007000700000000000700070007000700070007000700070000000000070007000700070007000700070000000000000007000700070007000700070000000000000000";
dat4 = "0001000100010001000100010001000100010001000100010001000100010001000100010001000100010001000100010001000100010001000100010001000100010001000100010001000100010001000100010001000100010001000100010001000100010001000100010001000100010001000100010001000100010001000100010001000100010001000100010001000100010001000100010001000100010001000100010001000100010001000100010001000100010001000100010001000100010001";
dat5 = "15191919191919191919191519151519191919191915151519191919191915151515191919191919151515191519151915191915191919151915191919191919191915151919191919191915191519191919191515151915151919151515151515151212";
dat6 = "01040104010503010501050304020201030301030402040202020402030203030502020201160205030402030102020404020304020103050105030101030405040504020302040504050305020302020304010201050102020503050503040301050404";
dat7 = "0001000100010001000100010001000100010001000100010001000100010001000100010001000100010001000100010001000100010001000100010001000100010001000100010001000100010001000100010001000100010001000100010001000100010001000100010001000100010001000100010001000100010001000100010001000100010001000100010001000100010001000100010001000100010001000100010001000100010001000100010001000100010001000100010001000100010001";
dat8 = "0500050005000500050005000500050005000500050005000500050005000500050005000500050005000500050005000500050005000500050005000500050005000500050005000500050005000500050005000500050005000500050005000500050005000500050005000500050005000500050005000500050005000500050005000500050005000500050005000500050005000500050005000500050005000500050005000500050005000500050005000500050005000500050005000500050005190519";