
dat1 = "akakakakakakakakakak00000000000000000000000000000000000000000000000000000000000000000000000000000000000000000000000000zp0000000000000000000000000000000000000000000000000000000000";
dat2 = "99999999999999999999999999999999999999990000000000000100000000000000000000000000000000000000012000000000000000000000000000000000012000500020010000000000000000000000000001200000000001200050000000000000012001000020012000000000003400730100010000000000000000000050012002000000000000000000000000000010012000100000000000000000000000000000000000100000000000000000";
dat3 = "00070007000700070007000700070007000000000007000700070007000700070007000700070000000700070007000700070007000700070007000000070007000700070007000700070007000700070007000700070007000700070007000700070007000700070007000700070007000700070007000700070007000700070007000700070007000700070007000700070007000700070007000700070007000700070007000700070007000700070007";
dat4 = "00010001000100010001000100010001000100010001000100010001000100010001000100010001000100010001000100010001000100010001000100010001000100010001000100010001000100010001000100010001000100010001000100010001000100010001000100010001000100010001000100010001000100010001000100010001000100010001000100010001000100010001000100010001000100010001000100010001000100010001";
dat5 = "1919191919101010101019191919191010101010191919191919191010101919191919191919191919191919191919191919191919191919191919191919191919191919191919191919191919191919191919191919191919";
dat6 = "0707070707070707070704040104030403040305010103040405030305010304030402040102040103010404030202020201020403030103050402160102020102050402010305040201040301010302020402020204050503";
dat7 = "00010001000100010001000100010001000100010001000100010001000100010001000100010001000100010001000100010001000100010001000100010001000100010001000100010001000100010001000100010001000100010001000100010001000100010001000100010001000100010001000100010001000100010001000100010001000100010001000100010001000100010001000100010001000100010001000100010001000100010001";
dat8 = "05000500050005000500050005000500050005000500050005000500050005000500050005000500050005000500050005000500050005000500050005000500050005000500050005000500050005000500050005000500050005000500050005000500050005000500050005000500050005000500050005000500050005000500050005000500050005000500050005000500050005000500050005000500050005000500050005000500050005000500";